1,1,0,0,0,0
2,1,0,0,0,0
3,1,0,0,1,0
4,1,1,1,0,0
5,1,1,1,0,0
1,2,1,0,1,0
2,2,1,0,1,0
3,2,0,0,0,0
4,2,1,0,1,1
5,2,1,0,0,1
1,3,0,0,1,1
2,3,1,0,0,1
3,3,1,0,1,1
4,3,1,0,1,1
5,3,0,0,0,1
1,4,0,0,1,1
2,4,0,0,0,1
3,4,1,0,0,1
4,4,0,0,0,1
5,4,1,0,0,1
1,5,0,0,1,1
2,5,0,0,0,1
3,5,0,0,1,1
4,5,0,0,0,1
5,5,0,0,0,1
